encouragment = words or behaviour that give someone confidence to do something
praise = to express admiration or approval of the achievements or characteristics of a person or thing
express = to show a feelings, opinion, or fact
admiration = the feeling of admiring someone or something
admire = to find someone or something attractive and pleasant to look at
pleasant  = enjoyable, attractive, friendly, or easy to like
approve = to have a positive opinion of someone or something
approval = the feeling of having a postive opinion of someone or something
co-worker = a person who you work with, especially someone with a similar job or level of responsibility
complaining = the act of saying that something is wrong or not satisfactory
bitter = Having a strong, often unpleasant taste e.g. coffee, dark chocolate.
sweet = Usually an enjoyable taste of sugar.
dry = Not wet.
moist = A little wet.
bland = Boring, not interesting.
spicy = Having strong flavours from spice.
savoury = Not sweet e.g. bread.
rich = Rich food has a lot of butter, cream, or eggs in it.
salty = Tastes of salt.
tasty = Good flavour and is nice to eat.
sugary = Tastes of sugar.
greasy = Containing or covered with fat or oil.
scrumptious = delicious.
sour = Having a sharp taste e.g yogurt, lemon.
piping hot = Very hot.
crunchy = Firm and making a loud noise when it is eaten.
hung up = to end a phone conversation
anxiety = something that causes a feeling of fear and worry
eanger = wanting very much to do or have something, especially something interesting or enjoyable
delay = to cause someone or something to be slow or late
originally  = first of all
proper = real, satisfactory, suitable, or correct
painless = causing no physical pain
hang out = to spend a lot of time in a place or with somesone
give up = to stop owning, using, or claiming something
claim = to say that something is true or is a fact, although you cannot prove it and other people might not believe it
cut out = to stop eating or drinking something, usually to improve your health
in spite of = even though there is something unpleasant or bad happening
detach = to separate or remove something from something else that it is connected to
bounce = to (cause to) move up or away after hitting a surface
ought = used to say that the action expressed in the verb is probable or expected
desirable = worth having and wanted by most people
desire = to want something, especially strongly
extinct = not now existing
proper = real, satisfactory, suitable, or correct 
refuse = to say that you will not do or accept something
